{
  "88": 2,
  "89": 0,
  "90": 3,
  "91": 1,
  "92": 1,
  "93": 0,
  "94": 0,
  "95": 4,
  "96": 4,
  "97": 2,
  "10": 0,
  "98": 2,
  "11": 2,
  "12": 2,
  "13": 2,
  "14": 4,
  "15": 4,
  "16": 0,
  "17": 0,
  "18": 0,
  "19": 3,
  "0": 0,
  "1": 2,
  "2": 2,
  "3": 4,
  "4": 4,
  "5": 0,
  "6": 0,
  "7": 1,
  "8": 1,
  "9": 3,
  "20": 0,
  "21": 1,
  "22": 2,
  "23": 2,
  "24": 0,
  "25": 0,
  "26": 0,
  "27": 3,
  "28": 0,
  "29": 0,
  "30": 0,
  "31": 1,
  "32": 2,
  "33": 2,
  "34": 2,
  "35": 0,
  "36": 0,
  "37": 0,
  "38": 1,
  "39": 1,
  "40": 0,
  "41": 0,
  "42": 2,
  "43": 2,
  "44": 2,
  "45": 2,
  "46": 0,
  "47": 0,
  "48": 0,
  "49": 1,
  "50": 1,
  "51": 0,
  "52": 0,
  "53": 0,
  "54": 2,
  "55": 2,
  "56": 2,
  "57": 2,
  "58": 0,
  "59": 0,
  "60": 1,
  "61": 1,
  "62": 0,
  "63": 0,
  "64": 0,
  "65": 2,
  "66": 2,
  "67": 2,
  "68": 1,
  "69": 0,
  "70": 0,
  "71": 0,
  "72": 3,
  "73": 0,
  "74": 0,
  "75": 0,
  "76": 2,
  "77": 2,
  "78": 1,
  "79": 0,
  "80": 3,
  "81": 0,
  "82": 0,
  "83": 0,
  "84": 4,
  "85": 4,
  "86": 2,
  "87": 2
}