{
  "88": 3,
  "89": 1,
  "90": 1,
  "91": 1,
  "92": 0,
  "93": 3,
  "94": 3,
  "95": 1,
  "96": 0,
  "97": 0,
  "10": 1,
  "98": 0,
  "11": 3,
  "12": 3,
  "13": 0,
  "14": 0,
  "15": 0,
  "16": 3,
  "17": 0,
  "18": 4,
  "19": 1,
  "0": 0,
  "1": 0,
  "2": 0,
  "3": 0,
  "4": 1,
  "5": 3,
  "6": 3,
  "7": 0,
  "8": 1,
  "9": 1,
  "20": 3,
  "21": 3,
  "22": 1,
  "23": 1,
  "24": 2,
  "25": 2,
  "26": 0,
  "27": 0,
  "28": 0,
  "29": 2,
  "30": 1,
  "31": 3,
  "32": 1,
  "33": 2,
  "34": 2,
  "35": 2,
  "36": 2,
  "37": 2,
  "38": 2,
  "39": 2,
  "40": 2,
  "41": 1,
  "42": 4,
  "43": 2,
  "44": 3,
  "45": 3,
  "46": 2,
  "47": 0,
  "48": 2,
  "49": 2,
  "50": 2,
  "51": 2,
  "52": 2,
  "53": 2,
  "54": 3,
  "55": 3,
  "56": 2,
  "57": 4,
  "58": 1,
  "59": 2,
  "60": 2,
  "61": 2,
  "62": 2,
  "63": 2,
  "64": 2,
  "65": 2,
  "66": 2,
  "67": 1,
  "68": 3,
  "69": 1,
  "70": 2,
  "71": 0,
  "72": 0,
  "73": 0,
  "74": 2,
  "75": 2,
  "76": 1,
  "77": 1,
  "78": 3,
  "79": 3,
  "80": 1,
  "81": 4,
  "82": 0,
  "83": 3,
  "84": 0,
  "85": 0,
  "86": 0,
  "87": 3
}