{
  "88": 3,
  "89": 0,
  "90": 1,
  "91": 1,
  "92": 2,
  "93": 2,
  "94": 4,
  "95": 1,
  "96": 0,
  "97": 0,
  "10": 0,
  "98": 0,
  "11": 3,
  "12": 3,
  "13": 0,
  "14": 4,
  "15": 4,
  "16": 2,
  "17": 2,
  "18": 4,
  "19": 1,
  "0": 0,
  "1": 0,
  "2": 0,
  "3": 0,
  "4": 1,
  "5": 4,
  "6": 2,
  "7": 2,
  "8": 1,
  "9": 1,
  "20": 0,
  "21": 3,
  "22": 1,
  "23": 1,
  "24": 4,
  "25": 0,
  "26": 2,
  "27": 2,
  "28": 0,
  "29": 4,
  "30": 0,
  "31": 0,
  "32": 1,
  "33": 0,
  "34": 0,
  "35": 2,
  "36": 2,
  "37": 2,
  "38": 0,
  "39": 0,
  "40": 1,
  "41": 4,
  "42": 4,
  "43": 0,
  "44": 2,
  "45": 2,
  "46": 2,
  "47": 0,
  "48": 4,
  "49": 4,
  "50": 4,
  "51": 4,
  "52": 0,
  "53": 2,
  "54": 2,
  "55": 2,
  "56": 0,
  "57": 4,
  "58": 4,
  "59": 1,
  "60": 0,
  "61": 0,
  "62": 2,
  "63": 2,
  "64": 2,
  "65": 0,
  "66": 0,
  "67": 1,
  "68": 0,
  "69": 0,
  "70": 4,
  "71": 0,
  "72": 2,
  "73": 2,
  "74": 0,
  "75": 4,
  "76": 1,
  "77": 1,
  "78": 3,
  "79": 0,
  "80": 1,
  "81": 4,
  "82": 2,
  "83": 2,
  "84": 4,
  "85": 4,
  "86": 0,
  "87": 3
}